111111111111111111111111111111
100000000000000000000000000501
100000050750505500500500000001
100005000000000000000070000001
100000000040406000000400000001
100004440030034430000000000001
100070060000000000000040000001
100400030000004000000000000001
100070020020200000000003000001
104000000070000000006003000001
104000200000004200000003000001
100003000000100000200003000001
104000300010001000000030007001
104000300100000104020000000001
144000301000008000000030000001
104600300100000000046030004001
100400000011000011000000004001
106000302000101000000200004001
100000300200000006000400004001
100500300000000000002030004001
100500033000000000000200000001
100500000030060000022230004001
100060000733300000227000000001
100500000020202020000000400001
105020202000030000002204000001
105000000700000300304300055001
105050500505050500005070000001
100000000000000000000000000001
100000000000000000000000000001
111111111111111111111111111111
